,37,,,36,35,,,34,,,
1,,25,24,23,,,,33,,,2
,38,,,22,,21,-2,,,,
7,,-2,,-2,,-2,-2,-2,-2,8,9
17,,,-2,-2,-2,-2,-2,-2,,,
6,,26,-2,-2,-2,-2,,32,,,
,39,,-2,-2,-2,-2,-2,31,,,
18,,-2,-2,-2,-2,20,-2,,19,,11
,50,27,,-2,-2,,,,,,10
15,49,48,,-2,-2,,13,,14,,12
16,40,28,,,29,41,42,30,,,
5,4,47,46,45,,44,43,,,,3
e,,,,,,,,,,,
/,0,0,,,,,,,,,
MINION,MINION,/,10,1,,,,,,,
